~~~~~~~~~
~.=.=.=.~
~.=.=.=.~
~.=.=.=.~
~.=.=.=.~
~.......~
~~~~~~~~~